*******************************************************************************************
S                             *     *           *  *     *        *              *        *
                              *     *           *  *     *        *              *        *
*  *************  **********  *  *  *******  *  *  *  *  *  ****  *  **********  *******  *
*     *           *        *     *     *     *  *     *     *     *  *     *     *        *
*     *           *        *     *     *     *  *     *     *     *  *     *     *        *
****  **********  *  ****  ****  ****  *  ****  **********  *  ****  *  *  *  ****  *******
*  *  *           *     *        *     *  *     *           *  *     *  *        *     *  *
*  *  *           *     *        *     *  *     *           *  *     *  *        *     *  *
*  *  *  *************************  *******  ****  **********  *  ****  *************  *  *
*     *                 *  *        *        *     *           *  *  *  *     *     *     *
*     *                 *  *        *        *     *           *  *  *  *     *     *     *
**********  **********  *  *  *******  *******  ****  **********  *  *  *  *  *  *  ****  *
*     *     *           *     *     *  *     *  *  *     *     *  *     *  *  *  *        *
*     *     *           *     *     *  *     *  *  *     *     *  *     *  *  *  *        *
*  *  *******  *************  *  *  *  *  *  *  *  *  *  *  *  *  *  *******  *  **********
*  *  *     *  *        *     *  *        *     *     *     *     *  *        *  *        *
*  *  *     *  *        *     *  *        *     *     *     *     *  *        *  *        *
*  *  *  *  *  *  ****  *  ****  ****  **********************  ****  *  ****  *  *  *  ****
*  *  *  *        *     *        *  *  *     *     *        *  *  *     *  *     *  *     *
*  *  *  *        *     *        *  *  *     *     *        *  *  *     *  *     *  *     *
*  ****  ****  *******************  *  *  *  ****  *  ****  *  *  ****  *  *******  ****  *
*  *     *  *  *     *           *     *  *           *        *     *  *        *  *     *
*  *     *  *  *     *           *     *  *           *        *     *  *        *  *     *
*  *  ****  *  *  *  *  *  *************  *************  *  *******  *******  *  ****  *  *
*  *     *  *     *  *  *              *  *  *           *  *        *     *  *     *  *  *
*  *     *  *     *  *  *              *  *  *           *  *        *     *  *     *  *  *
*  ****  *  *******  *  ****************  *  *  **********  *  *  ****  *  *******  *  ****
*     *  *  *        *                    *  *     *        *  *  *  *  *     *     *     *
*     *  *  *        *                    *  *     *        *  *  *  *  *     *     *     *
****  *  *  *  ****************************  ****  *  **********  *  *  ****  *  *  *  *  *
*  *     *     *     *     *              *        *           *           *  *  *  *  *  *
*  *     *     *     *     *              *        *           *           *  *  *  *  *  *
*  *  **********  *  *  *  *  **********  ****  *************  ****  *  ****  *  *  ****  *
*  *  *        *  *  *  *  *           *     *     *     *  *     *  *  *     *  *        *
*  *  *        *  *  *  *  *           *     *     *     *  *     *  *  *     *  *        *
*  *  *  ****  *  *  ****  **********  ****  *  ****  *  *  ****  ****  *  ****  *  ****  *
*     *  *     *  *        *           *  *  *  *     *           *     *        *     *  *
*     *  *     *  *        *           *  *  *  *     *           *     *        *     *  *
*******  *  ****  **********  **********  *  ****  ****************  *******  *******  *  *
*  *     *        *           *        *  *     *     *     *     *  *        *  *     *  *
*  *     *        *           *        *  *     *     *     *     *  *        *  *     *  *
*  *  *************  **********  ****  *  ****  *  *  *  *  *  *  *  *  *******  *  ****  *
*  *     *     *     *        *     *     *     *  *  *  *     *  *  *  *     *  *  *     *
*  *     *     *     *        *     *     *     *  *  *  *     *  *  *  *     *  *  *     *
*  ****  *  *  *******  ****  *  *  *******  ****  ****  *******  *  *  ****  *  *  *  ****
*     *     *     *     *     *  *     *     *           *  *     *  *        *     *     *
*     *     *     *     *     *  *     *     *           *  *     *  *        *     *     *
****  ****  ****  ****  *******  ****  *  ****  *  *******  *  ****  *******************  *
*     *        *     *        *     *     *     *     *     *     *  *              *     *
*     *        *     *        *     *     *     *     *     *     *  *              *     *
*  ****  **********  ****  *******  *******  *******  ****  ****  *  *  **********  *  ****
*        *        *     *                    *     *     *  *  *     *  *  *     *  *  *  *
*        *        *     *                    *     *     *  *  *     *  *  *     *  *  *  *
****************  *  *  **********  **********  *  ****  *  *  *******  *  *  *  *  *  *  *
*           *     *  *  *  *           *     *  *           *  *     *  *  *  *     *     *
*           *     *  *  *  *           *     *  *           *  *     *  *  *  *     *     *
*  *******  *  ****  *  *  *  *******  *  ****  *******  ****  ****  *  *  *  *************
*        *  *  *     *     *        *  *        *     *  *           *     *              *
*        *  *  *     *     *        *  *        *     *  *           *     *              *
*******  *  *  *  ****************  *************  *  *  *  *  *************  *  *******  *
*     *  *     *                    *              *     *  *     *     *     *  *        *
*     *  *     *                    *              *     *  *     *     *     *  *        *
*  *  *  ****************************  *******************  ****  ****  *  ****  *  *******
*  *  *        *              *        *        *        *     *        *  *     *        *
*  *  *        *              *        *        *        *     *        *  *     *        *
****  ****  ****  **********  *  *******  ****  *  ****  *  *  **********  ****  *******  *
*     *           *     *     *        *     *  *  *  *     *  *        *     *  *     *  *
*     *           *     *     *        *     *  *  *  *     *  *        *     *  *     *  *
*  ****  *******  *  *  *  **********  *  *  *  *  *  *  ****  *  ****  ****  ****  *  *  *
*        *     *  *  *  *              *  *  *  *  *     *        *           *     *     *
*        *     *  *  *  *              *  *  *  *  *     *        *           *     *     *
*******  ****  *  *  *******************  *  *  *  ****************  **********  **********
*  *     *     *  *        *     *     *  *  *     *              *        *  *        *  *
*  *     *     *  *        *     *     *  *  *     *              *        *  *        *  *
*  *  ****  *************  *  *  *  *  ****  *******  **********  *******  *  ****  *  *  *
*  *     *  *     *  *        *     *        *     *           *  *        *        *  *  *
*  *     *  *     *  *        *     *        *     *           *  *        *        *  *  *
*  ****  *  *  *  *  *  *  **********************  *  *  ****  *  ****  *************  *  *
*           *  *        *  *              *        *  *  *     *        *        *        *
*           *  *        *  *              *        *  *  *     *        *        *        *
*******  ****  **********  *  **********  *  *  ****  *  *  **********  *******  *  *  ****
*     *     *     *        *  *           *  *  *     *  *  *        *        *  *  *     *
*     *     *     *        *  *           *  *  *     *  *  *        *        *  *  *     *
*  *******  *******  *******  *  **********  *  *******  *  *  *  *  *******  *  *  *******
*           *        *        *           *  *  *     *  *  *  *  *  *        *  *        *
*           *        *        *           *  *  *     *  *  *  *  *  *        *  *        *
*  *************  ****  ****************  ****  *  *  *  *  ****  *  *  *******  *******  *
*                       *                       *  *     *        *  *           *        *
*                       *                       *  *     *        *  *           *       E*
*******************************************************************************************