**********************
*   *   ** **     *   
* *   * E     *** * **
* * *  **  ****   * **
*** ******    *** *  *
*          **  **    *
***** ******   ***** *
*     *   *******  * *
* *******         *  *
*                 * ***
******* ********** ***
******* **************
*   *   *****     *   
* *   *       *** * **
* * *  **  ****   * **
*** *****     *** *  *
*          **  **    *
***** *** **   ***** *
*     *   *******  * *
* *******      S *   *
*                * ***
****************** ***